NO ./textures/temple1.xpm
SO ./textures/temple2.xpm
WE ./textures/temple3.xpm
EA ./textures/temple4.xpm

F 55, 55, 55
C 122,122,122

1111111111111111111
1010101000000010101
1000100000000000101
1010101000000010101
1000000000000000001
1000000000000010101
1000001000000010101
1010001000000010101
1010000000000000001
1101001000000000001
1010000001010000001
1000001010101010101
1000001010101010101
1000000010101010101
1000000000000000001
1000000010101010101
1000000000100010001
1000000010101010101
1111111111111111111