NO ./textures/NO.xpm
SO ./textures/SO.xpm
WE ./textures/WE.xpm
EA ./textures/EA.xpm

F 220,100,0
C 225,30,0

11111111111111111111111111
11111110000000000000000N01
10000000000000000001111111
1   10000000000000000001
100000000 0000000001
10000000000000000001
10000000000000000001
11111111111111111111