NO ./textures/NO.xpm
SO ./textures/SO.xpm
WE ./textures/WE.xpm
EA ./textures/EA.xpm

F 55, 55, 55
C 122,122,122

11111111111111111111111111
11111110000000000N00000001
10000000000000000001111111
10000000000000000001
10000000000000000001
10000000000000000001
10000000000000000001
11111111111111111111