NO ./textures/NO.xpm
SO ./textures/SO.xpm
WE ./textures/WE.xpm
EA ./textures/EA.xpm

F 55, 55, 55
C 122,122,122

1111111111111111111111111111111111111111111111111111111
1001000000000000000000000001001000000000000000000000001
1010010010000100000000000000000011111111111111111111111
1100N10010000000000000000000000010010000000000000000001
1111011111111111111111111111000000000000000000000000001
1001000000000000000000000001000010010000000000000000001
1001000000000000000000000001000010010000000000000000001
1001000000000000000000000001111111111110000000000000001
1001000000000000000000000001111111111110000000000000001
1001000000000000000000000001000001111111111000001111111
1001000000000000000000000001000001111111111000001111111
1001000000000000000000000001000001111111111000001111111
1111111111111111111111111111111111111111111111111111111